11111111111111111111111111111111
11111111111111111111111111111111
11111111111111111111111111111111
11111111111111111111111111111111
11111111111111111111111111111111
11111111111111111111111111111111
11111111111111111100001111111111
11111111111111111100001111111111
11111111111111111100001111111111
11111111000000000000001111111111
11111111000000000000001111111111
11111111000000000000111111111111
11111111000000000000111111111111
10000000000000000000111111111111
10000000000000000000111111111111
11111111000000000000111111111111
11111111000000000000001111111111
11111111000000000000001111111111
11111111000000000000001111111111
11111111111111111100001111111111
11111111111111111100001111111111
11111111111111111100001111111111
11111111111111111100001111111111
11111111111111111100001111111111
11111111111111111100001111111111
11111111111111111100001111111111
11111111111111111111111111111111
11111111111111111111111111111111
11111111111111111111111111111111
11111111111111111111111111111111
11111111111111111111111111111111
11111111111111111111111111111111
